# # # # # # # # # # # # # # # # #
# . . . . . . . # . . . . . . . #
# . # # . # # . # . # # . # # . #
# . # . . . . . # . . . . . # . #
# . # . # # # . # . # # # . # . #
# . # . . . . . . . . . . . # . #
# . . . # # # # # # # # # . . . #
# . . . . . # . # . # . . . . . #
# # # . # . # . . . # . # . # # #
# . . . # . . . # . . . # . . . #
# . # . # # # # # # # # # . # . #
# . # . . . . . . . . . . . # . #
# . # . # # # . # . # # # . # . #
# . # . . . . . # . . . . . # . #
# . # # . # # . # . # # . # # . #
# . . . . . . . # . . . . . . . #
# # # # # # # # # # # # # # # # #