# # # # # # # # # # # # # # # # #
# . . . . . . . # . . . . . . . #
# . # # . # # . # . # # . # # . #
# . # . . . . . # . . . . . # . #
# . # . # # # . # . # # # . # . #
# . # . . . . . . . . . . . # . #
# . . . # # # # # # # # # . . . #
# . . . . . . . # . . . . . . . #
# # # . . . . . . . . . . . # # #
# . . . . . . . # . . . . . . . #
# . . . # # # # # # # # # . . . #
# . # . . . . . . . . . . . # . #
# . # . # # # . # . # # # . # . #
# . # . . . . . # . . . . . # . #
# . # # . # # . # . # # . # # . #
# . . . . . . . # . . . . . . . #
# # # # # # # # # # # # # # # # #