# # # # # # # # # # # # # # # # #
# . . . . . . . # . . . . . . . #
# . # # # # # . # . # # # # # . #
# . # . . . . . . . . . . . # . #
# . . . # . # . # # # . # . . . #
# . # . # . # . . . # . # . # . #
# . # . # . # # # . # . # . # . #
# . . . . . # . . . # . . . . . #
# # # # # . # # . # # . # # # # #
# . . . . . # . . . # . . . . . #
# . # . # . # # # . # . # . # . #
# . # . # . # . . . # . # . # . #
# . . . # . # . # # # . # . . . #
# . # . . . . . . . . . . . # . #
# . # # # # # . # . # # # # # . #
# . . . . . . . # . . . . . . . #
# # # # # # # # # # # # # # # # #